.........................
.........................
......*$$$$$$$...........
...........*********.....
.........********........
......***////*****.......
......*****++++*****.....
.....****************....
......**************.....
.....**************......
.........................
....../////////////......
.........................
.........................
.........................
.........................
.........................
.........................
.........................
.........................