..........................
..........................
..........................
.....$$..........$$.......
.....$$..........$$.......
..........................
..........................
..........................
...........**.............
...........**.............
..........................
..........................
../.................../...
../////////////////////...
..........................
..........................
..........................
..........................
..........................
..........................